........
........
........
........
........
........
........
........
........
........
........
........
........
........
##......
........
........
........
........
........
........
.#......
#.......
.#......
........
........
........
........
........
.#######
#.......
........
........
........
........
........
#.......
.#######
#.......
........