8 5 100
6 0 0 0 5 0 6 0
3 2 3 6 5 4 5 0
1 0 0 1 8 4 5 3
8 9 6 6 7 1 5 9
0 5 7 9 0 3 0 5
1 0 0 0 0 0 4 8
0 9 0 3 0 0 0 8
0 0 9 1 0 7 5 0
1 6
7 7
5 5
6 5
3 2
5 7
5 3 8
0 0 0 0 1
9 2 2 0 0
0 1 0 1 0
0 0 0 1 0
0 0 0 0 0
1 3
3 1
3 5
3 3

